NO textures/egypt/north.xpm
SO textures/egypt/south.xpm
WE textures/egypt/west.xpm
EA textures/egypt/east.xpm

F 210,150,75
C 101,67,33

1111111111111111111111111111111111111111
1000000000000000010010010000000000000001
1000000000000000000000000000000000000001
1000111111100011111111111111111111111101
1000000000000000000000000000000000000001
1001011111111000111001111000111111001001
1001011111111111111001111111111111000001
10010110000000000000000000000000C1001001
1001011011111100001110001111000110100101
1001011011111111111110111111111101001001
1001111011000000000000000000001101001001
1001011011011110111111111011101101001001
10010110110100000000C0000000101101001001
1001011011010000000000000000101101001001
1001111011010011111100011100101101000001
1001011011010010000000000100101101001001
1000011000010010010101100100101101001001
1001011011010010010101100100101101001001
1001011011010010010110100100101101001001
1001011011010010010100100100101101001101
1000011000010011010110100100101101000001
1001011011010010010110100100101101001001
1001011011011110010110111100101101001001
1001011011000001010110010000101101001001
1M00011011100000010110000000101101000101
1001011011111111110111111111101101001001
1001011000000000000000000000001101001001
1001011111110011110111111111111101001001
1001011111110011110111111111111101001001
1001000000000000M10100000000000001001001
1001100111111110010110111111111111001001
100000000000011011001100000C000000000001
1M00000000000010000110110000000000001001
1110011110111110010110111100111111111001
1M00000001M00000010110000000000000000001
1C000000000M0000W10100000000000001000011
1111111111111111111111111111111111111111